7x9
C7 N5 F8 N2 N5 C7 D4 C2 D2 
C7 D8 R1 R5 D5 N7 C2 F4 C8 
R5 F6 C1 R5 N9 D7 C9 N2 R2 
C7 R2 R8 N1 N7 R3 F5 F8 R8 
N6 F5 N2 D2 F5 D6 C2 R8 C3 
F6 N7 F4 D1 C8 R2 F1 R7 C5 
N4 F6 R8 R3 N3 F5 C4 N7 F2 